XEEXXXXXXX
X P   XX X
XPXXX  XXX
X      X X
X X    X X
X    F X X
X      XXX
XX    X  X
X   XXXX X
XXXXXXXXXX

XEEXXXXXXX
X P   XX X
X XXX  XXX
XP     X X
X X    X X
X    F X X
X      XXX
XX    X  X
X   XXXX X
XXXXXXXXXX

XEEXXXXXXX
X P   XX X
X XXX  XXX
X      X X
XPX    X X
X    F X X
X      XXX
XX    X  X
X   XXXX X
XXXXXXXXXX

XEEXXXXXXX
X P   XX X
X XXX  XXX
X      X X
X X    X X
XP   F X X
X      XXX
XX    X  X
X   XXXX X
XXXXXXXXXX

XEEXXXXXXX
X P   XX X
X XXX  XXX
X      X X
X X    X X
X P  F X X
X      XXX
XX    X  X
X   XXXX X
XXXXXXXXXX

XEEXXXXXXX
X P   XX X
X XXX  XXX
X      X X
X X    X X
X  P F X X
X      XXX
XX    X  X
X   XXXX X
XXXXXXXXXX

XEEXXXXXXX
X P   XX X
X XXX  XXX
X      X X
X X    X X
X   PF X X
X      XXX
XX    X  X
X   XXXX X
XXXXXXXXXX

