XEEXXXXXXXXXXXXXXXXX
X          XXXX XXXX
XP  X XXX  X X X X X
X XXX XXX  XXXXXXXXX
X XXX X  X  XX    XX
X XX  X XX X XX    X
X XXXXXX X   XXXXXXX
X  XXXXX   X  XX  XX
X   X XX    X XXXXXX
X  XX XX     XXXX XX
X         F  XX  X X
X XXXXX X    XXXXX X
XX    X X X X X XXXX
XX   XX XXXX XXXXXXX
XXXX XXX  XX  X XX X
XX    X   XXXXX   XX
XXXXX XXX X  X  XXXX
X XX    XXX XXXXX XX
XXXXX   XX     X XXX
XXXXXXXXXXXXXXXXXXXX

XEEXXXXXXXXXXXXXXXXX
X          XXXX XXXX
X   X XXX  X X X X X
XPXXX XXX  XXXXXXXXX
X XXX X  X  XX    XX
X XX  X XX X XX    X
X XXXXXX X   XXXXXXX
X  XXXXX   X  XX  XX
X   X XX    X XXXXXX
X  XX XX     XXXX XX
X         F  XX  X X
X XXXXX X    XXXXX X
XX    X X X X X XXXX
XX   XX XXXX XXXXXXX
XXXX XXX  XX  X XX X
XX    X   XXXXX   XX
XXXXX XXX X  X  XXXX
X XX    XXX XXXXX XX
XXXXX   XX     X XXX
XXXXXXXXXXXXXXXXXXXX

XEEXXXXXXXXXXXXXXXXX
X          XXXX XXXX
X   X XXX  X X X X X
X XXX XXX  XXXXXXXXX
XPXXX X  X  XX    XX
X XX  X XX X XX    X
X XXXXXX X   XXXXXXX
X  XXXXX   X  XX  XX
X   X XX    X XXXXXX
X  XX XX     XXXX XX
X         F  XX  X X
X XXXXX X    XXXXX X
XX    X X X X X XXXX
XX   XX XXXX XXXXXXX
XXXX XXX  XX  X XX X
XX    X   XXXXX   XX
XXXXX XXX X  X  XXXX
X XX    XXX XXXXX XX
XXXXX   XX     X XXX
XXXXXXXXXXXXXXXXXXXX

XEEXXXXXXXXXXXXXXXXX
X          XXXX XXXX
X   X XXX  X X X X X
X XXX XXX  XXXXXXXXX
X XXX X  X  XX    XX
XPXX  X XX X XX    X
X XXXXXX X   XXXXXXX
X  XXXXX   X  XX  XX
X   X XX    X XXXXXX
X  XX XX     XXXX XX
X         F  XX  X X
X XXXXX X    XXXXX X
XX    X X X X X XXXX
XX   XX XXXX XXXXXXX
XXXX XXX  XX  X XX X
XX    X   XXXXX   XX
XXXXX XXX X  X  XXXX
X XX    XXX XXXXX XX
XXXXX   XX     X XXX
XXXXXXXXXXXXXXXXXXXX

XEEXXXXXXXXXXXXXXXXX
X          XXXX XXXX
X   X XXX  X X X X X
X XXX XXX  XXXXXXXXX
X XXX X  X  XX    XX
X XX  X XX X XX    X
XPXXXXXX X   XXXXXXX
X  XXXXX   X  XX  XX
X   X XX    X XXXXXX
X  XX XX     XXXX XX
X         F  XX  X X
X XXXXX X    XXXXX X
XX    X X X X X XXXX
XX   XX XXXX XXXXXXX
XXXX XXX  XX  X XX X
XX    X   XXXXX   XX
XXXXX XXX X  X  XXXX
X XX    XXX XXXXX XX
XXXXX   XX     X XXX
XXXXXXXXXXXXXXXXXXXX

XEEXXXXXXXXXXXXXXXXX
X          XXXX XXXX
X   X XXX  X X X X X
X XXX XXX  XXXXXXXXX
X XXX X  X  XX    XX
X XX  X XX X XX    X
X XXXXXX X   XXXXXXX
XP XXXXX   X  XX  XX
X   X XX    X XXXXXX
X  XX XX     XXXX XX
X         F  XX  X X
X XXXXX X    XXXXX X
XX    X X X X X XXXX
XX   XX XXXX XXXXXXX
XXXX XXX  XX  X XX X
XX    X   XXXXX   XX
XXXXX XXX X  X  XXXX
X XX    XXX XXXXX XX
XXXXX   XX     X XXX
XXXXXXXXXXXXXXXXXXXX

XEEXXXXXXXXXXXXXXXXX
X          XXXX XXXX
X   X XXX  X X X X X
X XXX XXX  XXXXXXXXX
X XXX X  X  XX    XX
X XX  X XX X XX    X
X XXXXXX X   XXXXXXX
X  XXXXX   X  XX  XX
XP  X XX    X XXXXXX
X  XX XX     XXXX XX
X         F  XX  X X
X XXXXX X    XXXXX X
XX    X X X X X XXXX
XX   XX XXXX XXXXXXX
XXXX XXX  XX  X XX X
XX    X   XXXXX   XX
XXXXX XXX X  X  XXXX
X XX    XXX XXXXX XX
XXXXX   XX     X XXX
XXXXXXXXXXXXXXXXXXXX

XEEXXXXXXXXXXXXXXXXX
X          XXXX XXXX
X   X XXX  X X X X X
X XXX XXX  XXXXXXXXX
X XXX X  X  XX    XX
X XX  X XX X XX    X
X XXXXXX X   XXXXXXX
X  XXXXX   X  XX  XX
X   X XX    X XXXXXX
XP XX XX     XXXX XX
X         F  XX  X X
X XXXXX X    XXXXX X
XX    X X X X X XXXX
XX   XX XXXX XXXXXXX
XXXX XXX  XX  X XX X
XX    X   XXXXX   XX
XXXXX XXX X  X  XXXX
X XX    XXX XXXXX XX
XXXXX   XX     X XXX
XXXXXXXXXXXXXXXXXXXX

XEEXXXXXXXXXXXXXXXXX
X          XXXX XXXX
X   X XXX  X X X X X
X XXX XXX  XXXXXXXXX
X XXX X  X  XX    XX
X XX  X XX X XX    X
X XXXXXX X   XXXXXXX
X  XXXXX   X  XX  XX
X   X XX    X XXXXXX
X  XX XX     XXXX XX
XP        F  XX  X X
X XXXXX X    XXXXX X
XX    X X X X X XXXX
XX   XX XXXX XXXXXXX
XXXX XXX  XX  X XX X
XX    X   XXXXX   XX
XXXXX XXX X  X  XXXX
X XX    XXX XXXXX XX
XXXXX   XX     X XXX
XXXXXXXXXXXXXXXXXXXX

XEEXXXXXXXXXXXXXXXXX
X          XXXX XXXX
X   X XXX  X X X X X
X XXX XXX  XXXXXXXXX
X XXX X  X  XX    XX
X XX  X XX X XX    X
X XXXXXX X   XXXXXXX
X  XXXXX   X  XX  XX
X   X XX    X XXXXXX
X  XX XX     XXXX XX
X P       F  XX  X X
X XXXXX X    XXXXX X
XX    X X X X X XXXX
XX   XX XXXX XXXXXXX
XXXX XXX  XX  X XX X
XX    X   XXXXX   XX
XXXXX XXX X  X  XXXX
X XX    XXX XXXXX XX
XXXXX   XX     X XXX
XXXXXXXXXXXXXXXXXXXX

XEEXXXXXXXXXXXXXXXXX
X          XXXX XXXX
X   X XXX  X X X X X
X XXX XXX  XXXXXXXXX
X XXX X  X  XX    XX
X XX  X XX X XX    X
X XXXXXX X   XXXXXXX
X  XXXXX   X  XX  XX
X   X XX    X XXXXXX
X  XX XX     XXXX XX
X  P      F  XX  X X
X XXXXX X    XXXXX X
XX    X X X X X XXXX
XX   XX XXXX XXXXXXX
XXXX XXX  XX  X XX X
XX    X   XXXXX   XX
XXXXX XXX X  X  XXXX
X XX    XXX XXXXX XX
XXXXX   XX     X XXX
XXXXXXXXXXXXXXXXXXXX

XEEXXXXXXXXXXXXXXXXX
X          XXXX XXXX
X   X XXX  X X X X X
X XXX XXX  XXXXXXXXX
X XXX X  X  XX    XX
X XX  X XX X XX    X
X XXXXXX X   XXXXXXX
X  XXXXX   X  XX  XX
X   X XX    X XXXXXX
X  XX XX     XXXX XX
X   P     F  XX  X X
X XXXXX X    XXXXX X
XX    X X X X X XXXX
XX   XX XXXX XXXXXXX
XXXX XXX  XX  X XX X
XX    X   XXXXX   XX
XXXXX XXX X  X  XXXX
X XX    XXX XXXXX XX
XXXXX   XX     X XXX
XXXXXXXXXXXXXXXXXXXX

XEEXXXXXXXXXXXXXXXXX
X          XXXX XXXX
X   X XXX  X X X X X
X XXX XXX  XXXXXXXXX
X XXX X  X  XX    XX
X XX  X XX X XX    X
X XXXXXX X   XXXXXXX
X  XXXXX   X  XX  XX
X   X XX    X XXXXXX
X  XX XX     XXXX XX
X    P    F  XX  X X
X XXXXX X    XXXXX X
XX    X X X X X XXXX
XX   XX XXXX XXXXXXX
XXXX XXX  XX  X XX X
XX    X   XXXXX   XX
XXXXX XXX X  X  XXXX
X XX    XXX XXXXX XX
XXXXX   XX     X XXX
XXXXXXXXXXXXXXXXXXXX

XEEXXXXXXXXXXXXXXXXX
X          XXXX XXXX
X   X XXX  X X X X X
X XXX XXX  XXXXXXXXX
X XXX X  X  XX    XX
X XX  X XX X XX    X
X XXXXXX X   XXXXXXX
X  XXXXX   X  XX  XX
X   X XX    X XXXXXX
X  XX XX     XXXX XX
X     P   F  XX  X X
X XXXXX X    XXXXX X
XX    X X X X X XXXX
XX   XX XXXX XXXXXXX
XXXX XXX  XX  X XX X
XX    X   XXXXX   XX
XXXXX XXX X  X  XXXX
X XX    XXX XXXXX XX
XXXXX   XX     X XXX
XXXXXXXXXXXXXXXXXXXX

XEEXXXXXXXXXXXXXXXXX
X          XXXX XXXX
X   X XXX  X X X X X
X XXX XXX  XXXXXXXXX
X XXX X  X  XX    XX
X XX  X XX X XX    X
X XXXXXX X   XXXXXXX
X  XXXXX   X  XX  XX
X   X XX    X XXXXXX
X  XX XX     XXXX XX
X      P  F  XX  X X
X XXXXX X    XXXXX X
XX    X X X X X XXXX
XX   XX XXXX XXXXXXX
XXXX XXX  XX  X XX X
XX    X   XXXXX   XX
XXXXX XXX X  X  XXXX
X XX    XXX XXXXX XX
XXXXX   XX     X XXX
XXXXXXXXXXXXXXXXXXXX

XEEXXXXXXXXXXXXXXXXX
X          XXXX XXXX
X   X XXX  X X X X X
X XXX XXX  XXXXXXXXX
X XXX X  X  XX    XX
X XX  X XX X XX    X
X XXXXXX X   XXXXXXX
X  XXXXX   X  XX  XX
X   X XX    X XXXXXX
X  XX XX     XXXX XX
X       P F  XX  X X
X XXXXX X    XXXXX X
XX    X X X X X XXXX
XX   XX XXXX XXXXXXX
XXXX XXX  XX  X XX X
XX    X   XXXXX   XX
XXXXX XXX X  X  XXXX
X XX    XXX XXXXX XX
XXXXX   XX     X XXX
XXXXXXXXXXXXXXXXXXXX

XEEXXXXXXXXXXXXXXXXX
X          XXXX XXXX
X   X XXX  X X X X X
X XXX XXX  XXXXXXXXX
X XXX X  X  XX    XX
X XX  X XX X XX    X
X XXXXXX X   XXXXXXX
X  XXXXX   X  XX  XX
X   X XX    X XXXXXX
X  XX XX     XXXX XX
X        PF  XX  X X
X XXXXX X    XXXXX X
XX    X X X X X XXXX
XX   XX XXXX XXXXXXX
XXXX XXX  XX  X XX X
XX    X   XXXXX   XX
XXXXX XXX X  X  XXXX
X XX    XXX XXXXX XX
XXXXX   XX     X XXX
XXXXXXXXXXXXXXXXXXXX

