XEEXXXXXXXXXXXXXXXXXXXXXXXXXXX
XPP              XXXX X   X  X
X  XX XX  X  XX XX X     X XXX
X X X  XXX XXXX  X  X X   XXXX
X  X  XXX  X  X XX XX X X XXXX
X  X     XXX  X  XX  X   XX  X
X XX X XXXXXX X  XX   XX X X X
X  X  X XX X X  X         XX X
X XX    X  X X    X X XX XX  X
X X XXX  XX X   X XX    XXXX X
X X X   XXX   X  X  XX X  XX X
X X XX XX XX X  X   XXXXX X  X
X  X XX X XX XX    XXXXXXXXXXX
X X XXXXX X XXX XX X X X  XX X
X X X X X XX X   X   X X  XXXX
X              F XX XXXX  XX X
X XX XXX X X X       X   XX XX
XXXXX  X  X  X X   X        XX
X   XX XXXXXXX X XXXXXX XXX XX
X    XXXXX XX XXXXX X XX  XXXX
XX XX    XX X XXX XXXXX XXXXXX
XX   X XXXXX X X  X X  XX XXXX
X XXX X XX X    X     X  X X X
X X X  XXXX    X  XXXX XX  X X
X X   XXX XX X  XX  X  XXXX  X
X XX X  X  X X X XXXXX  XX  XX
XX  XX   X X  XX   XX    X X X
X   XXXX  X  XXXXX  X XXX   XX
XX X  X      XXXX      X    XX
XXXXXXXXXXXXXXXXXXXXXXXXXXXXXX
