XEEXXXXXXXXXXXXXXXXX
XooooooooooX  X   XX
XoXXXX XXXo XXX XXXX
XoXXXX    o   X X  X
Xo  X XX Xo X   X XX
XoXXXXX   o  XX  X X
XoXX  XXX o XXX   XX
XoXX   X XoXX X   XX
XoXXXXXX Xo   X X XX
Xo        o   X  X X
XoooooooooS       XX
XX  X XX    XXX X XX
X X X   X XX XXX  XX
X  XXX XX   X    XXX
XX XXXXXX X  XXX XXX
XXXX  XX X    XX X X
XXX XX    XXX XX  XX
X  XXXXXXXXXXX XX XX
X   X X  X XXX  X XX
XXXXXXXXXXXXXXXXXXXX
