XEEXXXXXXXXXXXXXXXXXXXXXXXXXXX
XoooooooooooooooX XXX X  XXXXX
Xo   X  X XXX  oXXX XX XX  X X
XoX  X  X  X  Xo X X  XXX    X
XoX XXXX X  X Xo X  XXXX     X
Xo      X     XoX   X  X X X X
XoX  X  X X X Xo X XX  XXX X X
XoX      XXXX  oXXX     X    X
XoX  XX  X   X o X    XXXX XXX
Xo  X     XX XXoXX X XXX XXXXX
XoXXX XXX  X   o   X X      XX
Xo  X XXXX     o  X     X X  X
XoX    X  XXXX oX X   X     XX
Xo     XXX X   o X X XX X XX X
XoX   X   X X  o XXXX XXXXX XX
XooooooooooooooS XXX XX    X X
X XX XX XXX      X XX  XX XX X
X   XXX  X XX XX X X X     XXX
X  XX  XX  XXX X XX  XXX  XXXX
XX X XXXX    XX XX     XX X  X
X XXX  X XX XXXXXX    XXXXXX X
XXXXX XXXXXXX   XX    X    XXX
X   X  XXX XX  X  X       XXXX
XX    XXXXX   XX   X XXX   XXX
X  X    X XX X X XX  XX XXXX X
X XXX XXX     X X  XXX XXXXX X
XX X X  XXX XXX X XX X  X XXXX
XX XX XX XXX XX XX   X X  XX X
X  X X    X   X         XX X X
XXXXXXXXXXXXXXXXXXXXXXXXXXXXXX
